....+#....+
..####.##.#
.+...###..#
##........#
#...@..#..#
###..###..#
.....#....#
.#####.#.##
.#......##

