.....#....#
..####+##.#
...w.###..#
##.w..@..w#
#+.....#.+#
###..###..#
..+..#....#
.#####.#.##
.#......##
.#.....##
.#######



