...+.#....+
..####.##.#
.....###..#
##....+...#
#+..@..#..#
###..###..#
.....#....#
.#####.#.##
.#......##
.#.....##
.#######
